1111111111
1000000C01
10P0000001
10C0000E01
1000000001
1111111111