1111111111111111111111
11P1000000000000C00001
101100000000E000000011
11000C0000000000011111
1111111111111111111111