11111111111111111111111111
1111C11000000000E000001111
10000000000C0000000C000011
1110000000000C00P111110011
100C000011000000000C001111
11111111111111111111111111