11111111111111111111
1000000P0000C00000E1
1000C000000C00000001
1000000000000000C001
11111111111111111111