11111111111
11000000001
10000C000P1
1000E000011
100C0000001
10000100001
10001C11111
11111111111