1111111111111111111
11000000000P00000C1
11111E000000000C111
1111111111100P001