11111111111
1100000C001
1000C0000P1
10000110001
100E000C0P1
11111111111