111111111111
11100C001111
1110P0000111
1100000C0001
11000E000111
1000C0000011
111000C00001
111111111111